[
    {
        "level": [[5,1,1,1,1,1,1,1,1,1,6,5,1,1,13,1,1,1,1,6],
                  [2,0,0,0,0,0,0,0,0,0,3,2,0,0,0,0,0,0,0,3],
                  [2,0,0,0,0,0,0,0,0,0,3,2,0,0,0,0,0,0,0,3],
                  [2,0,0,0,10,9,0,0,0,0,3,2,0,0,0,0,0,0,0,3],
                  [2,0,0,0,3,2,0,0,0,0,3,2,0,0,0,0,0,0,0,3],
                  [2,0,0,0,3,2,0,0,0,0,3,7,4,4,9,0,0,0,0,3],
                  [2,0,0,0,3,2,0,0,0,0,12,1,1,1,11,0,0,0,0,3],
                  [2,0,0,0,3,2,0,0,0,0,0,0,0,0,0,0,0,0,0,3],
                  [2,0,0,0,3,2,0,0,0,0,0,0,0,0,0,0,0,0,0,3],
                  [2,0,0,0,12,11,0,0,0,0,0,0,0,0,0,0,0,0,0,3],
                  [2,0,0,0,0,0,0,0,0,0,0,0,0,0,0,0,0,0,0,3],
                  [7,4,4,4,4,4,4,4,4,4,4,4,4,4,4,4,4,4,4,8]],

    "spawn_loc": [[100, 600], [600, 600], [800, 500], [296, 104], [128, 557], [608, 359], [908, 248], [1160, 359], [497, 260]],

    "player_loc": [100, 350],

    "enemy_amount": 3,

    "key_loc": [100, 100]
  },
  {
        "level": [[5,1,1,1,1,1,1,1,1,1,1,1,1,1,1,1,1,1,1,6],
                  [2,0,0,0,0,0,0,0,0,0,0,0,0,0,0,0,0,0,0,3],
                  [2,0,0,0,0,0,0,0,0,0,0,0,0,0,0,0,0,0,0,3],
                  [2,0,0,0,0,0,0,0,0,0,0,0,0,0,0,0,0,0,0,3],
                  [2,0,0,0,0,0,0,0,0,0,0,0,0,0,0,0,0,0,0,3],
                  [2,0,0,0,0,0,0,0,0,0,0,0,0,0,0,0,0,0,0,3],
                  [2,0,0,0,0,0,0,0,0,0,0,0,0,0,0,0,0,0,0,3],
                  [2,0,0,0,0,0,0,0,0,0,0,0,0,0,0,0,0,0,0,3],
                  [2,0,0,0,0,0,0,0,0,0,0,0,0,0,0,0,0,0,0,3],
                  [2,0,0,0,0,0,0,0,0,0,0,0,0,0,0,0,0,0,0,3],
                  [2,0,0,0,0,0,0,0,0,0,0,0,0,0,0,0,0,0,0,3],
                  [7,4,13,4,4,4,4,4,4,4,4,4,4,4,4,4,4,4,4,8]],

    "spawn_loc": [[100, 600], [600, 600], [800, 500], [296, 104], [128, 557], [608, 359], [908, 248], [1160, 359], [497, 260]],

    "player_loc": [300, 350],

    "enemy_amount": 3,

    "key_loc": [900, 500]
  }
]